NO parsing/xpmfile/NO.xpm
SO parsing/xpmfile/SO.xpm
WE parsing/xpmfile/WE.xpm
EA parsing/xpmfile/EA.xpm

F 10,255,255
C 225,255,255                 


111111111111111111111111111111
100000000000000000000000000001
1100000000000010000000000000001
100000001111111111110000000001
100000000000001000000000000001
100000000011111000000000000001
100000000010000000011111111111
10000000001000000001
10000000001000000S01     
10000000001000000001
100000000010110110011111111111
100000000000000010000000000001
1000000001111100010000000000001
100000000000000010000000000001
100000000000111110000000000001
100000000000000000000000000001
111111111111111111111111111111
